On	একটি
from	থেকে
the	এবং
of	এবং
announced	ঘোষণা
a	একটি
new	নতুন
that	যে
can	এবং
by	এবং
tiny	একটি
be	এবং
using	করে
for	জন্য
about	এবং
one	এবং
U.S.	মার্কিন
this	এই
may	যে
bring	এবং
and	এবং
to	এবং
in	এবং
countries,	এবং
where	যেখানে
rates	এবং
such	এবং
as	এবং
those	জন্য
countries.	জন্য
The	এবং
at	এবং
around	এবং
local	স্থানীয়
time	সময়
was	এবং
media	এবং
an	একটি
over	এবং
while	এবং
had	এবং
joined	বছর
three	থেকে
Since	থেকে
played	খেলা
protest	দিকে
started	শুরু
on	এবং
after	পরে
At	সময়
police	তারা
back	ফিরে
they	তারা
right	একটি
with	এবং
building	একটি
up	এবং
past	এক
along	একটি
were	এবং
their	তাদের
Grand	গ্র্যান্ড
against	বিরুদ্ধে
is	এবং
He	তিনি
points	পয়েন্ট
first	প্রথম
After	পরে
King	রাজা
said,	বলেছিলেন,
just	এবং
being	এবং
most	এবং
important	গুরুত্বপূর্ণ
I	আমি
try	ফিরে
million	মিলিয়ন
helped	এবং
other	অন্যান্য
British	ব্রিটিশ
used	ব্যবহার
There	এবং
several	এবং
both	এবং
New	এবং
once	একবার
held	এবং
American	আমেরিকান
during	এবং
might	হতে
country	এবং
also	এবং
more	বেশি
than	বেশি
these	এই
2	এর
goals	গোল
night	রাতের
his	তার
second	দ্বিতীয়
becoming	তার
or	বা
since	এবং
when	এবং
each	তাদের
significant	এবং
has	এবং
been	এবং
set	জন্য
became	পরে
there	কিছু
took	এবং
out	এবং
As	থেকে
ahead	তার
went	তিনি
under	এবং
he	তিনি
take	এবং
across	জুড়ে
its	এবং
light	এবং
have	এবং
five	এবং
show	এবং
only	এবং
would	এবং
book	একটি
then	এবং
through	এবং
provide	জন্য
children	তাদের
should	উচিত।
look	দেখতে
John	জন
home	এবং
said	যে
It	এটি
believed	বিশ্বাস
including	এবং
miles	মাইল
west	পশ্চিম
likely	বা
before	এবং
any	কোন
winds	বাতাস
per	প্রতি
hour	একটি
so	এবং
far	থেকে
major	এবং
year	জন্য
years	বছর
global	একটি
10	10
Zealand	থেকে
today	আজ
made	এবং
history	সম্পর্কে
Mr	মিস্টার
times	চেয়ে
see	বা
how	কত
going	করতে
because	কারণ
low	ছোট
down	এবং
In	এবং
last	থেকে
without	করা
order	এবং
who	এবং
did	করার
not	না
if	যদি
are	এবং
into	এবং
system	এবং
man	তার
support	এবং
power	তার
becomes	থেকে
it	এবং
we	আমরা
it.	একটি
That	হয়ে
no	কোনও
couple	ও
war	যুদ্ধ
hand	থেকে
experience	এবং
him	তিনি
possible	জন্য
These	এই
put	এই
end	এই
state	এবং
During	2
We	আমরা
make	এবং
Roman	রোমান
Earth,	পৃথিবীতে
National	ন্যাশনাল
legal	আইনী
do	না
now	এখন
many	এবং
help	এবং
March	জন্য
When	যখন
what	কী
involved	সাথে
another	অন্য
public	বা
War	এবং
which	যা
people,	এবং
but	কিন্তু
next	এবং
day.	করে
famous	বিখ্যাত
Greek	গ্রীক
found	এবং
within	মধ্যে
illegal	একটি
done	এবং
previous	এবং
years.	হাজার
A	একটি
few	জন্য
information	তথ্য
popular	এবং
top	জলের
saying	একটি
earlier	তার
two	এবং
meet	জন্য
This	এই
like	মতো
Its	এর
means	অর্থ
until	পর্যন্ত
amount	জন্য
Lake	এবং
school	করার
little	করার
However,	এবং
source	এবং
knowledge	এবং
old	একটি
known	এবং
will	এবং
led	কী
enough	যথেষ্ট
An	জন্য
established	একটি
Soviet	তিনি
thousands	হাজার
oil	তেল
test	একটি
caused	একটি
open	জন্য
near	একটি
station	এবং
still	এখনও
probably	সম্ভবত
area	এবং
live	এই
having	এবং
They	তারা
include	মধ্যে
financial	আর্থিক
European	ইউরোপীয়
foreign	বিদেশী
Northern	রক
much	এবং
traveling	বা
km	কিমি
go	বা
San	সান
return	ফিরে
northern	উত্তর
central	এবং
United	এবং
developed	চুক্তি
nation	দেশ
government	সরকার
countries	এবং
China	এবং
company	কোম্পানিটি
gain	এবং
areas	এবং
Scientists	বিজ্ঞানীরা
percent	শতাংশ
game	একটি
based	করা
between	মধ্যে
video	ভিডিও
Internet	ইন্টারনেট
considered	এবং
must	হবে।
States	এবং
located	এবং
received	জন্য
use	ব্যবহার
news	একটি
students	এবং
become	এবং
world	এবং
called	এবং
off	এবং
reported	এবং
best	এবং
Many	অনেক
great	দুর্দান্ত
event	একটি
part	একটি
city	শহর
world's	এবং
extra	অতিরিক্ত
additional	অতিরিক্ত
rather	এবং
normal	এবং
number	একটি
often	এবং
high	এবং
water	জলের
taken	শিখ
air	এবং
language	ভাষা
expect	এবং
keep	এবং
due	কারণে
positive	আধান
everything	এবং
able	এবং
own	এবং
With	সাথে
services	এবং
required	লেন্সের
people	মানুষ
Some	কিছু
very	খুব
remains	অনেক
four	জন্য
remaining	এবং
working	কাজ
way	এবং
them	তাদের
group	দল
attack	আক্রমণ
citizens	এই
places	জন্য
better	জন্য
some	কিছু
our	আমাদের
well	এবং
If	যদি
find	বা
One	তাদের
large	এবং
problems	এবং
individuals	এবং
came	তাদের
staying	বা
car	একটি
kilometres	মাইল)
hot	এবং
day	এবং
least	কমপক্ষে
get	এবং
person	ব্যক্তি
though	যদিও
good	এবং
work	কাজ
all	সমস্ত
trying	চেষ্টা
Airlines	বিমান
approach	পদ্ধতি
scene	মধ্যে
same	করতে
gas	গ্যাস
No	কোন
nearly	কাজ
Olympic	অলিম্পিক
it's	এই
think	করতে
place	এবং
energy	শক্তি
surface	জলের
events	এবং
know	এবং
-	একটি
you	আপনি
body	যা
regular	নিয়মিত
Indian	ভারতীয়
national	জাতীয়
don't	বা
control	করার
visit	এই
mostly	এবং
activity	মহাকাশযানের
outside	বাইরে
does	সম্পর্কে
While	এবং
less	কম
cause	এই
whether	ও
German	জার্মান
again	একটি
South	দক্ষিণ
animals	থাকে
international	আন্তর্জাতিক
change	পরিবর্তন
potential	সম্ভাব্য
could	পারে।
similar	একটি
either	বা
French	এবং
World	এবং
film	mm
later	পরে
English	এবং
words	শব্দ
size	এবং
For	জন্য
difficult	করা
medical	এবং
give	এবং
atoms	এবং
them.	তাদের
allows	করে।
things	মতো
modern	আধুনিক
ice	হয়ে
even	এবং
slightly	কিছুটা
call	কল
type	এই
lot	অনেক
makes	তৈরি
bulb	বাল্বের
longer	এবং
common	সাধারণ
small	ছোট
you.	আপনাকে
whole	এবং
thousand	প্রায়
long	এবং
century	সালে
–	-
ancient	প্রাচীন
spoken	এবং
languages	যা
island	সাথে
Most	বেশিরভাগ
ships	জাহাজ
built	নির্মিত
main	এবং
need	জন্য
Sea	সমুদ্র
travel	ভ্রমণ
limited	এবং
sometimes	কখনও
culture	এবং
among	এবং
understand	বুঝতে
different	বিভিন্ন
usually	সাধারণত
cultural	এবং
north	এবং
always	এবং
region	এবং
requires	জন্য
your	আপনার
learn	জন্য
lenses	লেন্সের
covers	কোন
easy	এবং
almost	এর
Spanish	চিলি
temple	মন্দির
offer	এবং
sure	আপনার
yourself	আপনি
certain	কিছু
Although	যদিও
especially	বিশেষত
easily	সহজেই
learning	এটি
enjoy	উপভোগ
obtain	আপনি
particular	নির্দিষ্ট
running	কিছু
real	জিনিস
You	আপনি
physical	শারীরিক
requirements	উপর
require	বিভিন্ন
available	হয়।
word	শব্দটি
us	আমাদের
something	একটি
offers	এবং
private	বা
summer	এবং
tourist	এবং
generally	সাধারণত
come	নেমে
trip	আপনার
Tours	রানিং
you're	জন্য
steep	এবং
de	মধ্যে
mm	mm
Running	রানিং
want	আপনি
snow	এবং
airline	এবং
