On	উপর
from	থেকে
the	এই
of	এর
announced	ঘোষণা করা
a	একটি
new	নতুন
that	যে
can	পারবে
by	দ্বারা
tiny	ছোট
be	হতে
using	ব্যবহার করে
for	জন্য
about	সম্পর্কে
one	এক
U.S.	মার্কিন যুক্তরাষ্ট্র
this	এটি
may	হতে পারে
bring	নিয়ে আসা
and	এবং
to	তে
in	এতে
countries,	দেশগুলি,
where	যেখানে
rates	হার
such	এমন
as	যেমন
those	সেগুলি
countries.	দেশগুলি।
The	এটি
at	এতে
around	চারদিকে
local	স্থানীয়
time	সময়
was	ছিল
media	মাধ্যম
an	একটি
over	অতিক্রম করা
while	যখন
had	পেয়েছিল
joined	যোগদান করেছে
three	তিন
Since	যেহেতু
played	খেলেছে
protest	বিক্ষোভ
started	শুরু হয়েছে
on	উপর
after	পরে
At	সময়
Here’s the corrected lexicon:
police	পুলিশ
back	ফিরে
they	তারা
right	সঠিক
with	সহ
building	ভবন
up	উপর
past	অতীত
along	সঙ্গে
were	ছিল
their	তাদের
Grand	গ্র্যান্ড
against	বিরুদ্ধে
is	হচ্ছে
He	তিনি
points	বিন্দু
first	প্রথম
After	পরে
King	রাজা
said,	বলেছিলেন,
just	শুধু
being	হওয়া
most	সবচেয়ে
important	গুরুত্বপূর্ণ
I	আমি
try	চেষ্টা
million	মিলিয়ন
helped	সাহায্য করেছে
other	অন্যান্য
British	ব্রিটিশ
used	ব্যবহৃত
There	সেখানে
several	কয়েকটি
both	দুইটি
New	নতুন
once	একবার
held	ধরে রাখা
American	আমেরিকান
during	দৌরান
might	শক্তি
country	দেশ
also	এছাড়াও
more	আরও
than	এর চেয়ে
these	এই
2	২
goals	লক্ষ্য
night	রাত
his	তার
second	দ্বিতীয়
becoming	হয়ে উঠছে
or	বা
since	যেহেতু
when	কখন
each	প্রতি
significant	গুরুত্বপূর্ণ
has	হয়
been	হয়েছে
set	নির্ধারণ
became	হয়ে গিয়েছিল
there	সেখানে
took	নিয়েছিল
out	বাহির
As	যেমন
ahead	সামনে
went	গিয়েছিল
under	নের নিচে
he	তিনি
take	নেওয়া
across	পার
its	এর
light	আলো
have	ধরতে
five	পাঁচ
show	দেখানো
only	শুধুমাত্র
would	হতো
book	বই
then	তখন
through	মধ্যে
provide	প্রদান করা
children	শিশুরা
should	উচিত
look	দেখা
John	জন
home	বাড়ি
said	বলেছে
It	এটি
believed	বিশ্বাস করা
including	সমেত
miles	মাইল
west	পশ্চিম
likely	সম্ভবত
before	আগে
any	কোনও
winds	বাতাস
per	প্রতি
hour	ঘণ্টা
so	তাহলে
far	দূর
major	প্রধান
year	বছর
years	বছর
global	বিশ্বজনীন
10	১০
Zealand	নিউজিল্যান্ড
today	আজ
made	তৈরি
history	ইতিহাস
Mr	মিস্টার
times	বার
see	দেখা
how	কীভাবে
going	যাচ্ছে
because	কারণ
low	নিম্ন
down	নিচে
In	মধ্যে
last	শেষ
without	ছাড়া
order	অর্ডার
who	কে
did	করেছে
not	না
if	যদি
are	আছে
into	মধ্যে
system	প্রণালী
man	পুরুষ
support	সমর্থন
power	শক্তি
becomes	হয়ে ওঠে
it	এটি
we	আমরা
it.	এটি।
That	সেটা
no	কোনও
couple	জোড়া
war	যুদ্ধ
hand	হাত
experience	অভিজ্ঞতা
him	তাকে
possible	সম্ভব
These	এই
put	রাখা
end	শেষ
state	রাষ্ট্র
During	দৌরান
We	আমরা
make	তৈরি করা
Here’s the corrected lexicon:
Roman	রোমান
Earth,	পৃথিবী,
National	জাতীয়
legal	আইনী
do	করতে
now	এখন
many	অনেক
help	সাহায্য
March	মার্চ
When	যখন
what	কী
involved	জড়িত
another	অন্য
public	জনসাধারণ
War	যুদ্ধ
which	যা
people,	মানুষ,
but	কিন্তু
next	পরবর্তী
day.	দিন।
famous	বিখ্যাত
Greek	গ্রীক
found	পেয়েছিল
within	মধ্যে
illegal	অবৈধ
done	সম্পন্ন
previous	পূর্ববর্তী
years.	বছর।
A	একটি
few	কিছু
information	তথ্য
popular	জনপ্রিয়
top	শীর্ষ
saying	বলছে
earlier	পূর্বে
two	দুই
meet	মিলিত
This	এটি
like	মতো
Its	এর
means	অর্থ
until	যতক্ষণ না
amount	পরিমাণ
Lake	ঝিল
school	বিদ্যালয়
little	ছোট
However,	তবে
source	উৎস
knowledge	জ্ঞান
old	পুরানো
known	জানা
will	হবে
led	নেতৃত্ব
enough	যথেষ্ট
An	একটি
established	প্রতিষ্ঠিত
Soviet	সোভিয়েত
thousands	হাজার
oil	তেল
test	পরীক্ষা
caused	কারণ
open	খোলা
near	নিকটবর্তী
station	স্টেশন
still	এখনও
probably	সম্ভবত
area	এলাকা
live	বাস করা
having	ধরতে
They	তারা
include	শামিল
financial	আর্থিক
European	ইউরোপীয়
foreign	বিদেশী
Northern	উত্তর
much	অনেক
traveling	ভ্রমণ
km	কিমি
go	যাওয়া
San	সান
return	ফিরে আসা
northern	উত্তর
central	মধ্য
United	একত্রিত
developed	উন্নত
nation	জাতি
government	সরকার
countries	দেশগুলি
China	চীন
company	কোম্পানি
gain	লাভ
areas	এলাকা
Scientists	বিজ্ঞানীরা
percent	শতাংশ
game	গেম
based	ভিত্তি
between	মধ্যবর্তী
video	ভিডিও
Internet	ইন্টারনেট
considered	গণ্য
Here’s the corrected lexicon:
must	অবশ্যই
States	রাষ্ট্র
located	অবস্থিত
received	প্রাপ্ত
use	ব্যবহার
news	সংবাদ
students	ছাত্র
become	হয়ে ওঠা
world	বিশ্ব
called	ডাকা
off	অফ
reported	প্রতিবেদিত
best	সেরা
Many	অনেক
great	মহান
event	ঘটনা
part	অংশ
city	শহর
world's	বিশ্বের
extra	অতিরিক্ত
additional	অতিরিক্ত
rather	বরং
normal	সাধারণ
number	সংখ্যা
often	প্রায়ই
high	উচ্চ
water	জল
taken	নেওয়া
air	বায়ু
language	ভাষা
expect	আশা করা
keep	রাখা
due	কারণে
positive	সकारাত্মক
everything	সবকিছু
able	ক্ষমতাশীল
own	নিজস্ব
With	সাথে
services	সেবা
required	প্রয়োজনীয়
people	মানুষ
Some	কিছু
very	খুব
remains	অবশিষ্ট
four	চার
remaining	অবশিষ্ট
working	কর্মরত
way	পদ্ধতি
them	তাদের
group	দল
attack	আক্রমণ
citizens	নাগরিক
places	স্থান
better	ভাল
some	কিছু
our	আমাদের
well	ভাল
If	যদি
find	খুঁজে পাওয়া
One	একটি
large	বৃহৎ
problems	সমস্যা
individuals	ব্যক্তি
came	এলো
staying	থাকা
car	গাড়ি
kilometres	কিমি
hot	গরম
day	দিন
least	কমপক্ষে
get	পাওয়া
person	ব্যক্তি
though	যদিও
good	ভাল
work	কাজ
all	সব
trying	চেষ্টা
Airlines	এয়ারলাইন
approach	পন্থা
scene	দৃশ্য
same	একই
gas	গ্যাস
No	না
nearly	প্রায়
Olympic	অলিম্পিক
it's	এটি
think	চিন্তা করা
place	স্থান
energy	শক্তি
surface	পৃষ্ঠ
events	ঘটনাবলী
know	জানা
-	-
you	আপনি
body	দেহ
regular	নিয়মিত
Indian	ভারতীয়
national	জাতীয়
don't	করবেন না
control	নিয়ন্ত্রণ
Here’s the corrected lexicon:
visit	ভ্রমণ
mostly	প্রধানত
activity	ক্রিয়াকলাপ
outside	বাইরে
does	করা
While	যখন
less	কম
cause	কারণ
whether	যদি
German	জার্মান
again	পুনরায়
South	দক্ষিণ
animals	পশু
international	আন্তর্জাতিক
change	পরিবর্তন
potential	সম্ভাব্য
could	পারবে
similar	সাদৃশ্য
either	একটি
French	ফরাসি
World	বিশ্ব
film	চলচ্চিত্র
later	পরে
English	ইংরেজি
words	শব্দ
size	আকার
For	জন্য
difficult	কষ্টকর
medical	চিকিৎসা
give	দেওয়া
atoms	অণু
them.	তাদের।
allows	অনুমতি দেয়
things	বিষয়গুলো
modern	আধুনিক
ice	বরফ
even	এমনকি
slightly	কিছুটা
call	কল
type	প্রকার
lot	অনেক
makes	তৈরি করে
bulb	বাল্ব
longer	আরও দীর্ঘ
common	সাধারণ
small	ছোট
you.	আপনাকে
whole	সম্পূর্ণ
thousand	হাজার
long	দীর্ঘ
century	শতাব্দী
–	–
ancient	প্রাচীন
spoken	কথিত
languages	ভাষা
island	দ্বীপ
Most	বেশিরভাগ
ships	জাহাজ
built	নির্মাণ করা
main	প্রধান
need	প্রয়োজন
Sea	সাগর
travel	ভ্রমণ
limited	সীমিত
sometimes	কখনও কখনও
culture	সংস্কৃতি
among	মধ্যে
understand	বুঝতে
different	বিভিন্ন
usually	সাধারণত
cultural	সাংস্কৃতিক
north	উত্তর
always	সর্বদা
region	অঞ্চল
requires	প্রয়োজন
your	আপনার
learn	শিখতে
lenses	লেন্স
covers	ঢেকে
easy	সহজ
almost	প্রায়
Spanish	স্প্যানিশ
temple	মন্দির
offer	প্রস্তাব
sure	নিশ্চিত
yourself	নিজেকে
certain	নিশ্চিত
Although	যদিও
especially	বিশেষত
easily	সহজে
learning	শেখা
enjoy	উপভোগ করা
obtain	প্রাপ্ত করা
particular	নির্দিষ্ট
running	চালানো
real	বাস্তব
You	আপনি
physical	শারীরিক
requirements	প্রয়োজনীয়তা
require	প্রয়োজন
Here’s the corrected lexicon:
available	উপলব্ধ
word	শব্দ
us	আমাদের
something	কিছু
offers	প্রস্তাব
private	ব্যক্তিগত
summer	গ্রীষ্ম
tourist	পর্যটক
generally	সাধারণত
come	আসা
trip	ভ্রমণ
Tours	ভ্রমণ
you're	আপনি
steep	খাড়া
de	তে
mm	mм
Running	দৌড়
want	চাই
snow	তুষার
airline	এয়ারলাইন